bbbbbbbbbbbbbbbbbbbb
b..................b
b...u..............b
b.p.u..............b
b.p................b
bbbbbbbbbbbbbbbb.bbb
b..................b
bk..k.........u....b
bbwwbwwb........d..b
bbbbbbbbbbb.bbbbbbbb
b..................b
b................k.b
b@.................b
bbbbbbbbbbbdbbbbbbbb