bbbbbbbbbbbbbbbbbbbb
b..................b
b........f.f.......b
b........f.f.....upb
bs.......f.f......pb
bs..bbbbbbbbbbbbbbbb
bs.....i...........b
bs.....i...........b
bs.....i...........b
bbbbbbbbbbbbs...bbbb
b...........s......b
b...........s.....kb
b@*.........s......b
bbbbbbbbbbbbbbbbbbbb