bbbbbbbbbbbbbbbbbbbb
b................b.b
b........f.f.......b
bs.......f.f.....upb
bs.......f.f.......b
bs..bbbbbbbbbbbbbbbb
bs.....i...........b
bs.....i...........b
bs.....i...........b
bbbbbbbbbbbbs...bbbb
b...........s......b
b@*.........s.....kb
b...........s......b
bbbbbbbbbbbbbbbbbbbb