bbbbbbbbbbbbbbbbbbbb
b...b..............b
b...u..............b
bpp.u......f.......b
b...b......f.......b
bbbbbbbbbbbbbbbb.bbb
b..................b
bk..k.........u....b
bbwwbwwb........d..b
bbbbbbbbbbb.bbbbbbbb
b..................b
b@*..............k.b
b..................b
bbbbbbbbbbbdbbbbbbbb