bbbbbbbbbbbbbbbbbbbb
b..................b
b...u..............b
bpp.u..............b
b..................b
bbbbbbbbbbbbbbbb.bbb
b..................b
bk..k.........u....b
bbwwbwwb........d..b
bbbbbbbbbbb.bbbbbbbb
b..................b
b@*..............k.b
b..................b
bbbbbbbbbbbdbbbbbbbb